000000000000001100000000000000
000000000000001100000000000000
001110000000000000000000011100
000000011100000000001110000000
000000010000000000000010000000
001100000000000000000000001100
000100000000000000000000001000
000100000000000000000000001000
000100110000000000000011001000
000100110000000000000011001000
000100000000000000000000001000
000100000000000000000000001000
001100000000000000000000001100
000000010000000000000010000000
000000011100000000001110000000
001110000000000000000000011100
000000000000001100000000000000
000000000000001100000000000000