000000000000000000000000000000
000111000000111111000000111000
000000000000000000000000000000
000000000000001100000000000000
000000000000000000000000000000
001111000010000000010000111100
000001000010000000010000100000
000001000000000000000000100000
000001010000000000000010100000
000001010000000000000010100000
000001000000000000000000100000
000001000010000000010000100000
001111000010000000010000111100
000000000000000000000000000000
000000000000001100000000000000
000000000000000000000000000000
000111000000111111000000111000
000000000000000000000000000000